18 32
--XXXXXXXXXXXXXXX----X----------
-XX--M-----X------X---X---------
-X---XXXX---X---X-X--X----------
-X-X-X---XX-X-X----X---------X--
-X-X--M-X---X-XX-X--M--------X--
-X-X--XXXX-X----X------------X--
-X---X--X----M--X----X-------X--
-X-XX-X--X--X-M-----X-------XX--
-X--X----X-XXXX---X-X-------X---
-X--XXXX-X--X-------X-------X---
-X-----X----X------X--------X---
-X-XXXX---XX------X---------X---
-X-----X---XX-X----X--------X---
-X--XXXXXX-M--X---X---------X---
---------X------X--X--------X---
----------X--X-----X----M---X---
----M-----XXXX-X---X--------XX--
------------X---X------------M-D
