18 32
--X--------------------X--------
-XX-----M--------------X--------
-XXXXXX----------------X--------
-X---------------------X--------
-X--------M-----------M---------
-X------------------------------
-X-----------------M------------
-X-------------------M----------
-X---------------------X--------
-X--------X---------------------
-X--------------X---------------
-X------M-----------------------
-X-------------------X----------
-X--------------M---------------
---------X------X---------------
----------------X--------------M
----M-----------X---------------
----------------X--------------E
