WWWWW
WSDFW
WPEFW
WIFFW
WWWWW

